"filename", "language", "java", "comment", "blank", "total"
"/home/valentin/Home/Koc/Semester2/KUTowerDefense/src/main/java/com/ku/towerdefense/Main.java", "java", 77, 5, 13, 95
"/home/valentin/Home/Koc/Semester2/KUTowerDefense/src/main/java/com/ku/towerdefense/controller/GameController.java", "java", 787, 129, 114, 1030
"/home/valentin/Home/Koc/Semester2/KUTowerDefense/src/main/java/com/ku/towerdefense/controller/GamePlayScreen.java", "java", 239, 16, 49, 304
"/home/valentin/Home/Koc/Semester2/KUTowerDefense/src/main/java/com/ku/towerdefense/model/GamePath.java", "java", 64, 6, 10, 80
"/home/valentin/Home/Koc/Semester2/KUTowerDefense/src/main/java/com/ku/towerdefense/model/GameSettings.java", "java", 342, 25, 76, 443
"/home/valentin/Home/Koc/Semester2/KUTowerDefense/src/main/java/com/ku/towerdefense/model/Path.java", "java", 123, 14, 29, 166
"/home/valentin/Home/Koc/Semester2/KUTowerDefense/src/main/java/com/ku/towerdefense/model/PathPoint.java", "java", 72, 0, 10, 82
"/home/valentin/Home/Koc/Semester2/KUTowerDefense/src/main/java/com/ku/towerdefense/model/effects/AnimatedEffect.java", "java", 65, 2, 9, 76
"/home/valentin/Home/Koc/Semester2/KUTowerDefense/src/main/java/com/ku/towerdefense/model/entity/ArcherTower.java", "java", 86, 7, 14, 107
"/home/valentin/Home/Koc/Semester2/KUTowerDefense/src/main/java/com/ku/towerdefense/model/entity/ArtilleryTower.java", "java", 91, 5, 14, 110
"/home/valentin/Home/Koc/Semester2/KUTowerDefense/src/main/java/com/ku/towerdefense/model/entity/DamageType.java", "java", 22, 0, 4, 26
"/home/valentin/Home/Koc/Semester2/KUTowerDefense/src/main/java/com/ku/towerdefense/model/entity/DroppedGold.java", "java", 63, 5, 13, 81
"/home/valentin/Home/Koc/Semester2/KUTowerDefense/src/main/java/com/ku/towerdefense/model/entity/Enemy.java", "java", 503, 76, 77, 656
"/home/valentin/Home/Koc/Semester2/KUTowerDefense/src/main/java/com/ku/towerdefense/model/entity/Entity.java", "java", 157, 4, 27, 188
"/home/valentin/Home/Koc/Semester2/KUTowerDefense/src/main/java/com/ku/towerdefense/model/entity/Goblin.java", "java", 44, 8, 9, 61
"/home/valentin/Home/Koc/Semester2/KUTowerDefense/src/main/java/com/ku/towerdefense/model/entity/Knight.java", "java", 70, 11, 14, 95
"/home/valentin/Home/Koc/Semester2/KUTowerDefense/src/main/java/com/ku/towerdefense/model/entity/MageTower.java", "java", 73, 0, 13, 86
"/home/valentin/Home/Koc/Semester2/KUTowerDefense/src/main/java/com/ku/towerdefense/model/entity/Projectile.java", "java", 261, 27, 53, 341
"/home/valentin/Home/Koc/Semester2/KUTowerDefense/src/main/java/com/ku/towerdefense/model/entity/Tower.java", "java", 305, 39, 58, 402
"/home/valentin/Home/Koc/Semester2/KUTowerDefense/src/main/java/com/ku/towerdefense/model/map/GameMap.java", "java", 430, 57, 68, 555
"/home/valentin/Home/Koc/Semester2/KUTowerDefense/src/main/java/com/ku/towerdefense/model/map/Tile.java", "java", 419, 47, 58, 524
"/home/valentin/Home/Koc/Semester2/KUTowerDefense/src/main/java/com/ku/towerdefense/model/map/TileType.java", "java", 47, 1, 11, 59
"/home/valentin/Home/Koc/Semester2/KUTowerDefense/src/main/java/com/ku/towerdefense/model/wave/Wave.java", "java", 52, 1, 13, 66
"/home/valentin/Home/Koc/Semester2/KUTowerDefense/src/main/java/com/ku/towerdefense/model/wave/WaveConfig.java", "java", 37, 7, 10, 54
"/home/valentin/Home/Koc/Semester2/KUTowerDefense/src/main/java/com/ku/towerdefense/ui/GameScreen.java", "java", 749, 124, 124, 997
"/home/valentin/Home/Koc/Semester2/KUTowerDefense/src/main/java/com/ku/towerdefense/ui/MainMenuScreen.java", "java", 141, 16, 20, 177
"/home/valentin/Home/Koc/Semester2/KUTowerDefense/src/main/java/com/ku/towerdefense/ui/MapEditorCanvasView.java", "java", 625, 96, 118, 839
"/home/valentin/Home/Koc/Semester2/KUTowerDefense/src/main/java/com/ku/towerdefense/ui/MapEditorScreen.java", "java", 627, 31, 100, 758
"/home/valentin/Home/Koc/Semester2/KUTowerDefense/src/main/java/com/ku/towerdefense/ui/MapEditorTilePalette.java", "java", 448, 53, 62, 563
"/home/valentin/Home/Koc/Semester2/KUTowerDefense/src/main/java/com/ku/towerdefense/ui/MapEditorTopToolbar.java", "java", 150, 28, 25, 203
"/home/valentin/Home/Koc/Semester2/KUTowerDefense/src/main/java/com/ku/towerdefense/ui/MapSelectionScreen.java", "java", 292, 43, 60, 395
"/home/valentin/Home/Koc/Semester2/KUTowerDefense/src/main/java/com/ku/towerdefense/ui/OptionsScreen.java", "java", 262, 20, 42, 324
"/home/valentin/Home/Koc/Semester2/KUTowerDefense/src/main/java/com/ku/towerdefense/ui/UIAssets.java", "java", 315, 28, 51, 394
"/home/valentin/Home/Koc/Semester2/KUTowerDefense/src/main/java/com/ku/towerdefense/util/GameSettings.java", "java", 359, 47, 105, 511
"Total", "-", 8397, 978, 1473, 10848